























           ________________________________________________________________________________________
          |////////////////////////////////////////////////////////////////////////////////////////|










_______________                                                                          ____     __
///////////////|                                                                        |////|   |//
///////////////|                                                                        |////|   |//
///////////////|                                                                        |////|   |//










