























   _______________                                     _____________________________________________
  |///////////////|                                   |/////////////////////////////////////////////










_____________________________________________________________________________________________      _
/////////////////////////////////////////////////////////////////////////////////////////////|    |/
/////////////////////////////////////////////////////////////////////////////////////////////|    |/
/////////////////////////////////////////////////////////////////////////////////////////////|    |/


