























   _______________                                     _____________________________________________
  |///////////////|                                   |/////////////////////////////////////////////










____________________________________________________________________________________________________
////////////////////////////////////////////////////////////////////////////////////////////////////
////////////////////////////////////////////////////////////////////////////////////////////////////
////////////////////////////////////////////////////////////////////////////////////////////////////

